10
10
*#*#_##*_*
#####**_#_
*##_**_***
**##_*##_#
___###*#*#
#**#*##__#
###**##**#
___#__*_#_
**__*_@_#_
*#_*#___##
